 2 2 2 2 2 1 2 2 2 2 2 1 1 1 1 2 2 2 2 2 2 1 1 1 2 2 2 2 1 1 1 2 2 2 2 2 2 1
 2 0 0 0 0 0 0 0 0 0 0 0 0 0 0 0 0 0 0 0 0 0 0 0 0 0 0 0 0 0 0 0 0 0 0 0 0 1
 2 0 99 0 0 0 0 0 0 0 0 0 0 0 0 0 0 0 0 0 0 0 0 0 0 0 0 0 0 0 0 0 0 0 98 0 0 2
 2 0 0 0 0 0 0 0 0 0 0 0 0 0 0 0 0 0 0 0 0 0 0 0 0 0 0 0 0 0 0 0 0 0 0 0 0 2
 2 0 0 0 0 0 0 0 0 0 0 0 0 0 0 0 0 0 0 0 0 0 0 0 0 0 0 0 0 0 0 0 0 0 0 0 0 2
 2 0 0 0 0 3 2 2 2 2 1 2 2 2 2 2 2 1 2 2 2 2 2 2 1 2 1 2 2 2 2 2 3 0 0 0 0 2
 2 0 0 0 0 2 0 0 0 0 0 0 0 0 0 0 0 0 0 0 0 0 0 0 0 0 0 0 0 0 0 0 2 0 0 0 0 2
 2 0 0 0 0 2 0 0 98 0 0 0 0 0 0 0 0 0 0 0 0 0 0 0 0 0 0 0 0 0 0 0 2 0 0 0 0 2
 1 0 0 0 0 2 0 0 0 0 0 0 0 0 0 0 0 0 0 0 0 0 0 0 0 0 0 0 0 0 0 0 2 0 0 0 0 1
 1 0 0 0 0 2 0 0 0 0 0 0 0 0 0 0 0 0 0 0 0 0 0 0 0 0 0 0 0 0 0 0 2 0 0 0 0 1
 1 0 0 0 0 2 0 0 0 0 1 2 2 2 2 2 4 0 0 0 0 4 2 2 2 2 2 1 0 0 0 0 2 0 0 0 0 1
 1 0 0 0 0 2 0 0 0 0 2 0 0 0 0 0 0 0 0 0 0 0 0 0 0 0 0 2 0 0 0 0 2 0 0 0 0 1
 1 0 0 0 0 2 0 0 0 0 2 0 0 0 0 0 0 0 0 0 0 0 0 0 0 0 0 2 0 0 0 0 2 0 0 0 0 2
 2 0 0 0 0 2 0 0 0 0 2 0 0 0 0 0 0 0 0 87 0 0 0 0 0 0 0 2 0 0 0 0 2 0 0 0 0 2
 2 0 0 0 0 2 0 0 0 0 2 0 0 0 0 0 8 8 5 5 8 8 0 0 0 0 0 2 0 0 0 0 2 0 0 0 0 2
 2 0 0 0 0 2 0 0 0 0 2 0 0 0 0 0 0 0 0 0 0 0 0 0 0 0 0 2 0 0 0 0 2 0 0 0 0 2
 2 0 0 0 0 2 0 0 0 0 2 0 0 0 0 0 0 0 0 0 0 0 0 0 0 0 0 2 0 0 0 0 1 0 0 0 0 2
 2 0 0 0 0 1 0 0 0 0 2 0 0 0 0 0 0 0 0 0 0 0 0 0 0 0 0 2 0 0 0 0 1 0 0 0 0 2
 2 0 0 0 0 1 0 0 0 0 2 0 0 0 0 0 0 0 0 0 0 0 0 0 0 0 0 2 0 0 0 0 2 0 0 0 0 2
 2 0 0 0 0 1 0 0 0 0 1 2 2 2 2 2 4 0 0 0 0 4 2 2 2 2 2 1 0 0 0 0 2 0 0 0 0 2
 2 0 0 0 0 1 0 0 0 0 0 0 0 0 0 0 6 0 0 0 0 7 0 0 0 0 0 0 0 0 0 0 1 0 0 0 0 2
 2 0 0 0 0 2 0 0 0 0 0 0 0 0 0 0 7 0 0 0 0 7 0 0 0 0 0 0 0 0 0 0 1 0 0 0 0 2
 2 0 0 0 0 2 0 0 0 0 0 0 0 0 0 0 6 0 0 0 0 7 0 0 0 0 0 0 0 98 0 0 1 0 0 0 0 2
 2 0 0 0 0 2 0 0 0 0 0 0 0 0 0 0 7 0 0 0 0 7 0 0 0 0 0 0 0 0 0 0 1 0 0 0 0 1
 2 0 0 0 0 3 2 2 2 2 2 7 0 0 0 0 6 0 0 0 0 3 0 0 0 0 2 2 2 2 2 2 3 0 0 0 0 1
 2 0 0 0 0 0 0 0 0 0 0 0 0 0 0 0 6 0 0 0 0 7 0 0 0 0 0 0 0 0 0 0 0 0 0 0 0 2
 2 0 0 0 0 0 00 0 0 0 0 0 0 0 0 0 7 0 0 0 0 7 0 0 0 0 0 0 0 0 0 0 0 0 0 0 0 2
 2 0 0 0 0 0 0 0 0 0 0 0 0 0 0 0 7 0 0 0 0 7 0 0 0 0 0 0 0 0 0 0 0 0 0 99 0 2
 2 0 0 0 0 0 0 0 0 0 0 0 0 0 0 0 6 2 76 2 2 3 0 0 0 0 0 0 0 0 0 0 0 0 0 0 0 2
 2 2 2 2 2 1 2 2 2 2 1 1 1 2 2 2 1 2 2 2 2 1 2 2 2 2 2 1 1 2 2 2 2 2 2 2 2 2