 1 1 1 1 1 1 4 2 2 2 1 1 1 1 1 1 4 4 1 1 1 2 2 2 2 2 2 2 4 1 1 1 1 1 1 1 1 1 
 1 0 0 0 0 0 0 0 0 0 0 0 0 0 0 0 0 0 0 0 0 0 0 0 0 0 0 0 0 0 0 0 0 0 0 0 0 1 
 2 0 99 0 0 0 0 0 0 0 0 0 0 0 0 0 0 0 0 0 0 0 0 0 0 0 0 0 0 0 0 0 0 0 99 0 0 1
 2 0 0 0 0 0 0 0 0 0 0 0 0 0 0 0 0 0 0 0 0 0 0 0 0 0 0 0 0 0 0 0 0 0 0 0 0 4 
 2 0 0 0 0 0 0 0 0 0 0 0 0 0 0 0 0 0 0 0 0 0 0 0 0 0 0 0 0 0 0 0 0 0 0 0 0 4 
 2 0 0 0 0 6 8 8 8 8 8 8 8 8 8 8 8 8 8 8 8 0 0 0 0 8 8 8 8 8 8 8 8 0 0 0 0 1 
 4 0 0 0 0 8 0 0 0 0 0 0 0 0 0 0 0 0 0 0 8 0 0 0 0 8 0 0 0 0 0 0 8 0 0 0 0 1 
 2 0 0 0 0 8 0 0 0 0 0 0 0 0 0 0 0 0 0 0 8 0 0 0 0 8 0 0 0 0 0 0 8 0 0 0 0 1 
 1 0 0 0 0 8 0 0 99 0 0 0 0 0 0 0 0 0 0 0 8 0 0 0 0 8 0 0 0 0 0 0 8 0 0 0 0 1
 1 0 0 0 0 8 0 0 0 0 0 0 0 0 0 0 0 0 0 0 0 0 0 0 0 0 0 0 0 0 0 0 8 0 0 0 0 1 
 1 0 0 0 0 8 0 0 0 0 0 0 0 0 0 0 0 0 0 0 0 0 0 0 0 0 0 0 0 0 0 0 8 0 0 0 0 2 
 1 0 0 0 0 8 0 0 0 0 0 0 0 0 0 6 6 0 0 0 0 0 0 0 0 0 6 6 0 0 0 0 8 0 0 0 0 2 
 1 0 0 0 0 8 0 0 0 0 0 0 0 0 0 6 0 0 0 0 0 0 0 0 0 0 0 6 0 0 0 0 8 0 0 0 0 2 
 1 0 0 0 0 8 0 0 0 0 0 0 0 0 0 0 0 0 0 0 0 0 0 0 0 0 0 0 0 0 0 0 8 0 0 0 0 4 
 1 0 0 0 0 8 0 0 0 0 0 0 0 0 0 0 0 0 0 0 0 0 0 0 0 0 0 0 0 0 0 0 8 0 0 0 0 1
 1 0 0 0 0 8 0 0 0 0 0 0 0 0 0 0 0 0 0 5 5 5 5 5 0 0 0 0 0 0 0 0 8 0 0 0 0 1 
 1 0 0 0 0 8 8 8 8 8 8 0 0 0 0 0 0 0 0 5 0 0 0 5 0 0 0 0 0 0 0 0 8 0 0 0 0 1
 2 0 0 0 0 8 8 8 76 8 8 0 0 0 0 0 0 0 0 5 0 88 0 5 0 0 0 0 0 0 0 0 8 0 0 0 0 1
 2 0 0 0 0 8 0 0 0 0 8 0 0 0 0 0 0 0 0 0 0 0 0 0 0 0 0 0 0 0 0 0 8 0 0 0 0 2 
 1 0 0 0 0 6 0 0 0 0 8 0 0 0 0 0 0 0 0 0 0 6 0 0 0 0 0 0 0 0 0 0 8 0 0 0 0 1 
 2 0 0 0 0 8 0 0 0 0 8 0 0 0 0 6 0 0 0 0 0 0 0 0 0 0 0 6 0 0 0 0 8 0 0 0 0 2 
 2 0 0 0 0 8 0 0 0 0 8 0 0 0 0 6 6 0 0 0 0 0 0 0 0 0 6 6 0 0 0 0 8 0 0 0 0 1 
 1 0 0 0 0 8 0 0 0 0 8 0 0 0 0 0 0 0 0 0 0 0 0 0 0 0 0 0 0 0 0 0 8 0 0 0 0 4 
 1 0 0 0 0 8 0 0 0 0 8 0 0 0 0 0 0 0 0 8 0 0 0 0 8 0 0 0 0 0 0 0 8 0 0 0 0 2 
 1 0 0 0 0 8 0 0 0 0 8 8 8 8 8 8 8 8 8 8 0 0 0 0 8 8 8 8 8 8 8 8 8 0 0 0 0 2 
 1 0 0 00 0 8 0 0 0 0 0 0 8 0 0 0 0 0 8 0 0 0 0 0 0 0 0 0 0 0 0 0 0 0 0 0 0 2
 4 0 0 0 0 0 0 0 0 0 0 0 8 0 87 0 0 0 0 8 0 0 0 0 0 0 0 0 0 0 0 0 0 0 0 99 0 1
 1 0 0 0 0 0 0 0 0 0 0 0 8 0 0 0 0 0 0 77 0 0 0 0 0 0 0 0 0 0 0 0 0 0 0 0 0 1
 1 0 0 00 0 0 0 88 0 0 0 8 0 8 0 0 0 0 0 8 0 0 0 0 0 0 0 0 0 0 0 0 0 0 0 0 0 1
 1 1 1 1 1 2 2 2 2 1 4 1 1 2 2 1 1 1 1 1 1 1 2 4 4 1 1 1 1 1 1 1 1 2 1 1 1 1 